level 2
next_level assets/level_1.map
map
# # # # # # # # # # # # # # # -1
# 0 0 E 0 0 0 0 0 0 0 0 0 0 L -1
# 0 0 0 0 0 0 0 0 K 0 0 0 0 # -1
# 0 S 0 0 0 0 0 0 0 0 0 E 0 # -1
# # # # # # # # # # # # # # # -2