level 1
next_level assets/level_2.map
next_level assets/level_4.map
map
# L # # # # # # # # # # # # # -1
# 0 0 0 0 0 0 0 0 0 0 0 0 0 # -1
# G 0 0 0 0 0 0 0 0 0 0 E 0 # -1
# 0 S 0 0 0 0 E 0 0 0 0 0 0 L -1
# # # # # # # # # # # # # # # -2