level 2
next_level assets/level_3.map
next_level assets/level_1.map
map
# # # # # # # # # # # # # # # -1
# 0 0 0 0 0 0 0 0 0 0 0 0 0 L -1
# 0 0 0 0 0 0 0 0 0 0 0 0 0 # -1
# S 0 0 0 0 0 0 0 0 0 0 E 0 # -1
# L # # # # # # # # # # # # # -2