level 4
next_level assets/level_4.map
next_level assets/level_1.map
map
# # L # # # # # # # # # # # # -1
# 0 S 0 # G # L # G 0 0 0 C # -1
# 0 0 0 0 G # 0 # G 0 0 0 E # -1
# 0 0 0 # 0 0 0 0 0 0 0 0 C # -1
# # # # # # # # # # # # # # # -2