level 4
next_level assets/level_1.map
next_level assets/level_2.map
next_level assets/level_3.map
map
# # L # # # # # # # # # # # # # # # -1
# 0 0 0 K # 0 0 G # D # G 0 0 0 C # -1
# 0 0 0 0 0 0 0 G # 0 # G 0 0 0 0 # -1
# 0 S 0 0 # 0 0 0 0 0 0 0 0 0 0 C # -1
# # # # # # # # # # # # # # # # # # -2